mode=Timer
timelimit=60
1 1 1 1 1 1 1 1 1
1 0 0 0 1 0 0 0 1
1 0 20 10 0 0 2 0 1
1 0 0 1 1 1 0 2 1
1 0 10 0 2 0 10 0 1
1 0 0 0 1 0 0 0 1
1 1 1 1 1 1 1 1 1