mode=Timer
timelimit=90
1 1 1 1 1 1 1 1 1 1
1 0 0 0 0 1 0 0 0 1
1 0 10 0 0 1 0 2 0 1
1 0 1 10 0 0 10 2 0 1
1 0 20 0 0 1 0 2 0 1
1 0 1 10 0 0 0 2 0 1
1 0 0 0 0 1 0 0 0 1
1 1 1 1 1 1 1 1 1 1