mode=Timer
timelimit=60
1 1 1 1 1 1 1 1 1
1 2 0 0 20 0 0 2 1
1 0 1 1 0 1 1 0 1
1 10 0 0 10 0 0 10 1
1 0 1 1 0 1 1 0 1
1 2 0 0 0 0 0 2 1
1 1 1 1 1 1 1 1 1