1 1 1 1 1 1 1 1 1
1 2 0 5 0 6 0 2 1
1 0 1 1 20 1 1 0 1
1 5 1 0 10 0 1 6 1
1 0 1 1 0 1 1 0 1
1 2 0 5 0 6 0 2 1
1 1 1 1 1 1 1 1 1