1 1 1 1 1 1 1
1 2 0 5 0 0 1
1 0 20 10 10 0 1
1 0 0 6 0 2 1
1 1 1 1 1 1 1