1 1 1 1 1 1 1 1 1
1 1 0 0 0 0 0 0 1
1 0 1 2 0 0 0 0 1
1 0 0 1 0 0 6 0 1
1 0 0 20 10 1 0 0 1
1 0 5 10 0 0 1 0 1
1 0 0 0 0 2 0 1 1
1 1 1 1 1 1 1 1 1
