0 0 1 1 1 1 0
1 1 1 0 0 1 0
1 20 0 2 10 1 1
1 0 0 0 10 0 1
1 0 1 2 0 0 1
1 0 0 0 0 0 1
1 1 1 1 1 1 1