1 1 1 1 1 1 1 1 1 1
1 0 0 5 1 0 6 0 0 1
1 0 10 0 1 20 0 10 0 1
1 2 0 6 1 0 5 0 2 1
1 1 1 1 1 1 1 1 1 1
1 2 0 5 1 0 6 0 2 1
1 0 10 0 1 0 0 10 0 1
1 0 0 6 1 0 5 0 0 1
1 1 1 1 1 1 1 1 1 1