1 1 1 1 1 1 1 1
1 2 0 5 0 0 2 1
1 1 1 0 1 1 0 1
1 0 20 0 10 6 0 1
1 0 1 1 1 1 0 1
1 0 5 0 0 6 2 1
1 1 1 1 1 1 1 1