1 1 1 1 1 1 1 1 1
1 2 0 1 20 1 0 2 1
1 0 10 0 0 0 10 0 1
1 1 0 1 0 1 0 1 1
1 2 10 0 0 0 10 2 1
1 0 0 1 0 1 0 0 1
1 1 1 1 1 1 1 1 1