1 1 1 1 1 1 1
1 0 5 0 2 0 1
1 0 0 1 0 6 1
1 1 0 2 10 0 1
1 20 0 10 0 0 1
1 0 0 1 0 0 1
1 1 1 1 1 1 1
