1 1 1 1 1 1 1 1
1 2 2 2 1 0 0 1
1 1 1 0 1 0 0 1
1 20 10 0 0 0 1 1
1 0 1 1 1 0 10 1
1 0 0 0 1 0 10 1
1 1 1 1 1 1 1 1