1,1,1,1,1,1
1,0,0,0,0,1
1,0,0,20,12,1
1,0,2,10,0,1
1,1,1,1,1,1
