1,1,1,1,1,1,1,1
1,0,0,0,0,0,0,1
1,0,20,1,0,10,2,1
1,0,0,1,1,0,0,1
1,0,10,1,1,10,2,1
1,0,0,0,0,0,2,1
1,1,1,1,1,1,1,1
0
37e0e28f05aa160ab05b70fe24ce899fbc85b7b7ba426754960c34a4460620f0
